10-|G
b-||--|---
--------|-
-|--|-----
--|-||----
-------|--
-----|-||-
---------|
|--------|
--||||----
-|--|-----
